ask somebody out	invite on a date	Brian a_ Judy o_ to dinner and a movie.	Brian asked Judy out to dinner and a movie.
ask around	ask many people the same question	I a_ a_ but nobody has seen my wallet.	I asked around but nobody has seen my wallet.
add up to something	equal	Your purchases a_ u_ to $205.32.	Your purchases add up to $205.32.
back something up	reverse	You'll have to b_ u_ your car so that I can get out.	You'll have to back up your car so that I can get out.
back somebody up	support	My wife b_ me u_ over my decision to quit my job.	My wife backed me up over my decision to quit my job.
blow up	explode	The racing car b_ u_ after it crashed into the fence.	The racing car blew up after it crashed into the fence.
blow something up	add air	We have to b_ 50 balloons u_ for the party.	We have to blow 50 balloons up for the party.
break down	stop functioning (vehicle, machine)	Our car b_ d_ at the side of the highway in the snowstorm.	Our car broke down at the side of the highway in the snowstorm.
break down	get upset	The woman b_ d_ when the police told her that her son had died.	The woman broke down when the police told her that her son had died.
break something down	divide into smaller parts	Our teacher b_ the final project d_ into three separate parts.	Our teacher broke the final project down into three separate parts.
break in	force entry to a building	Somebody b_ i_ last night and stole our stereo.	Somebody broke in last night and stole our stereo.
break into something	enter forcibly	The firemen had to b_ i_ the room to rescue the children.	The firemen had to break into the room to rescue the children.
break something in	wear something a few times so that it doesn't look/feel new	I need to b_ these shoes i_ before we run next week.	I need to break these shoes in before we run next week.
break in	interrupt	The TV station b_ i_ to report the news of the president's death.	The TV station broke in to report the news of the president's death.
break up	end a relationship	My boyfriend and I b_ u_ before I moved to America.	My boyfriend and I broke up before I moved to America.
break up	start laughing (informal)	The kids just b_ u_ as soon as the clown started talking.	The kids just broke up as soon as the clown started talking.
break out	escape	The prisoners b_ o_ of jail when the guards weren't looking.	The prisoners broke out of jail when the guards weren't looking.
break out in something	develop a skin condition	I b_ o_ i_ a rash after our camping trip.	I broke out in a rash after our camping trip.
bring somebody down	make unhappy	This sad music is b_ m_ down.	This sad music is bringing me down.
bring somebody up	raise a child	My grandparents b_ me u_ after my parents died.	My grandparents brought me up after my parents died.
bring something up	start talking about a subject	My mother walks out of the room when my father b_ u_ sports.	My mother walks out of the room when my father brings up sports.
bring something up	vomit	He drank so much that he b_ his dinner u_ in the toilet.	He drank so much that he brought his dinner up in the toilet.
call around	phone many different places/people	We c_ a_ but we weren't able to find the car part we needed.	We called around but we weren't able to find the car part we needed.
call somebody back	return a phone call	I c_ the company b_ but the offices were closed for the weekend.	I called the company back but the offices were closed for the weekend.
call something off	cancel	Jason c_ the wedding o_ because he wasn't in love with his fiancé.	Jason called the wedding off because he wasn't in love with his fiancé.
call on somebody	ask for an answer or opinion	The professor c_ o_ me for question 1.	The professor called on me for question 1.
call on somebody	visit somebody	We c_ o_ you last night but you weren't home.	We called on you last night but you weren't home.
call somebody up	phone	Give me your phone number and I will c_ you u_ when we are in town.	Give me your phone number and I will call you up when we are in town.
calm down	relax after being angry	You are still mad. You need to c_ d_ before you drive the car.	You are still mad. You need to calm down before you drive the car.
not care for somebody/ something	not like (formal)	I don't c_ f_ his behaviour.	I don't care for his behaviour.
catch up	get to the same point as somebody else	You'll have to run faster than that if you want to c_ u_ with Marty.	You'll have to run faster than that if you want to catch up with Marty.
check in	arrive and register at a hotel or airport	We will get the hotel keys when we c_ i_.	We will get the hotel keys when we check in.
check out	leave a hotel	You have to c_ o_ of the hotel before 11:00 AM.	You have to check out of the hotel before 11:00 AM.
check somebody/ something out	look at carefully, investigate	The company c_ o_ all new employees.	The company checks out all new employees.
check out somebody/ something	look at (informal)	C_ o_ the crazy hair on that guy!	Check out the crazy hair on that guy!
cheer up	become happier	She c_ u_ when she heard the good news.	She cheered up when she heard the good news.
cheer somebody up	make happier	I brought you some flowers to c_ you u_.	I brought you some flowers to cheer you up.
chip in	help	If everyone c_ i_ we can get the kitchen painted by noon.	If everyone chips in we can get the kitchen painted by noon.
clean something up	tidy, clean	Please c_ u_ your bedroom before you go outside.	Please clean up your bedroom before you go outside.
come across something	find unexpectedly	I c_ a_ these old photos when I was tidying the closet.	I came across these old photos when I was tidying the closet.
come apart	separate	The top and bottom c_ a_ if you pull hard enough.	The top and bottom come apart if you pull hard enough.
come down with something	become sick	My nephew c_ d_ w_ chicken pox this weekend.	My nephew came down with chicken pox this weekend.
come forward	volunteer for a task or to give evidence	The woman c_ f_ with her husband's finger prints.	The woman came forward with her husband's finger prints.
come from some place	originate in	The art of origami c_ f_ Asia.	The art of origami comes from Asia.
count on somebody/ something	rely on	I am c_ o_ you to make dinner while I am out.	I am counting on you to make dinner while I am out.
cross something out	draw a line through	Please c_ o_ your old address and write your new one.	Please cross out your old address and write your new one.
cut back on something	consume less	My doctor wants me to c_ b_ on sweets and fatty foods.	My doctor wants me to cut back on sweets and fatty foods.
cut something down	make something fall to the ground	We had to c_ the old tree in our yard d_ after the storm.	We had to cut the old tree in our yard down after the storm.
cut in	interrupt	Your father c_ i_ while I was dancing with your uncle.	Your father cut in while I was dancing with your uncle.
cut in	pull in too closely in front of another vehicle	The bus driver got angry when that car c_ i_.	The bus driver got angry when that car cut in.
cut in	start operating (of an engine or electrical device)	The air conditioner c_ i_ when the temperature gets to 22°C.	The air conditioner cuts in when the temperature gets to 22°C.
cut something off	remove with something sharp	The doctors c_ o_ his leg because it was severely injured.	The doctors cut off his leg because it was severely injured.
cut something off	stop providing	The phone company c_ o_ our phone because we didn't pay the bill.	The phone company cut off our phone because we didn't pay the bill.
cut somebody off	take out of a will	My grandparents c_ my father o_ when he remarried.	My grandparents cut my father off when he remarried.
cut something out	remove part of something (usually with scissors and paper)	I c_ this ad o_ of the newspaper.	I cut this ad out of the newspaper.
do somebody/ something over	beat up, ransack (BrE, informal)	He's lucky to be alive. His shop was d_ o_ by a street gang.	He's lucky to be alive. His shop was done over by a street gang.
do something over	do again (AmE)	My teacher wants me to d_ my essay o_ because she doesn't like my topic.	My teacher wants me to do my essay over because she doesn't like my topic.
do away with something	discard	It's time to d_ a_ with all of these old tax records.	It's time to do away with all of these old tax records.
do something up	fasten, close	D_ your coat u_ before you go outside. It's snowing!	Do your coat up before you go outside. It's snowing!
dress up	wear nice clothing	It's a fancy restaurant so we have to d_ u_.	It's a fancy restaurant so we have to dress up.
drop back	move back in a position/group	Andrea d_ b_ to third place when she fell off her bike.	Andrea dropped back to third place when she fell off her bike.
drop in/ by/ over	come without an appointment	I might d_ i_/b_/o_ for tea sometime this week.	I might drop in/by/over for tea sometime this week.
drop somebody/ something off	take somebody/ something somewhere and leave them/it there	I have to d_ my sister o_ at work before I come over.	I have to drop my sister off at work before I come over.
drop out	quit a class, school etc	I d_ o_ of Science because it was too difficult.	I dropped out of Science because it was too difficult.
eat out	eat at a restaurant	I don't feel like cooking tonight. Let's e_ o_.	I don't feel like cooking tonight. Let's eat out.
end up	eventually reach/do/decide	We e_ u_ renting a movie instead of going to the theatre.	We ended up renting a movie instead of going to the theatre.
fall apart	break into pieces	My new dress f_ a_ in the washing machine.	My new dress fell apart in the washing machine.
fall down	fall to the ground	The picture that you hung up last night f_ d_ this morning.	The picture that you hung up last night fell down this morning.
fall out	separate from an interior	The money must have f_ o_ of my pocket.	The money must have fallen out of my pocket.
fall out	(of hair, teeth) become loose and unattached	His hair started to f_ o_ when he was only 35.	His hair started to fall out when he was only 35.
figure something out	understand, find the answer	I need to f_ o_ how to fit the piano and the bookshelf in this room.	I need to figure out how to fit the piano and the bookshelf in this room.
fill something in	to write information in blanks, as on a form (BrE)	Please f_ i_ the form with your name, address, and phone number.	Please fill in the form with your name, address, and phone number.
fill something out	to write information in blanks, as on a form (AmE)	The form must be f_ o_ in capital letters.	The form must be filled out in capital letters.
fill something up	fill to the top	I always f_ the water jug u_ when it is empty.	I always fill the water jug up when it is empty.
find out	discover	We don't know where he lives. How can we f_ o_?	We don't know where he lives. How can we find out?
find something out	discover	We tried to keep the time of the party a secret, but Samantha f_ it o_.	We tried to keep the time of the party a secret, but Samantha found it out.
get something across/ over	communicate, make understandable	I tried to g_ my point a_/o_ to the judge but she wouldn't listen.	I tried to get my point across/over to the judge but she wouldn't listen.
get along/on	like each other	I was surprised how well my new girlfriend and my sister g_ a_/o_.	I was surprised how well my new girlfriend and my sister got along/on.
get around	have mobility	My grandfather can g_ a_ fine in his new wheelchair.	My grandfather can get around fine in his new wheelchair.
get away	go on a vacation	We worked so hard this year that we had to g_ a_ for a week.	We worked so hard this year that we had to get away for a week.
get away with something	do without being noticed or punished	Jason always g_ a_ with cheating in his maths tests.	Jason always gets away with cheating in his maths tests.
get back	return	We g_ b_ from our vacation last week.	We got back from our vacation last week.
get something back	receive something you had before	Liz finally g_ her Science notes b_ from my room-mate.	Liz finally got her Science notes back from my room-mate.
get back at somebody	retaliate, take revenge	My sister g_ b_ a_ me for stealing her shoes. She stole my favourite hat.	My sister got back at me for stealing her shoes. She stole my favourite hat.
get back into something	become interested in something again	I finally g_ ba_ i_ my novel and finished it.	I finally got back into my novel and finished it.
get on something	step onto a vehicle	We're going to freeze out here if you don't let us g_ o_ the bus.	We're going to freeze out here if you don't let us get on the bus.
get over something	recover from an illness, loss, difficulty	I just g_ o_ the flu and now my sister has it.	I just got over the flu and now my sister has it.
get over something	overcome a problem	The company will have to close if it can't g_ o_ the new regulations.	The company will have to close if it can't get over the new regulations.
get round to something	finally find time to do (AmE: get around to something)	I don't know when I am going to g_ r_ to writing the thank you cards.	I don't know when I am going to get round to writing the thank you cards.
get together	meet (usually for social reasons)	Let's g_ t_ for a BBQ this weekend.	Let's get together for a BBQ this weekend.
get up	get out of bed	I g_ u_ early today to study for my exam.	I got up early today to study for my exam.
get up	stand	You should g_ u_ and give the elderly man your seat.	You should get up and give the elderly man your seat.
give somebody away	reveal hidden information about somebody	His wife g_ him a_ to the police.	His wife gave him away to the police.
give somebody away	take the bride to the altar	My father g_ me a_ at my wedding.	My father gave me away at my wedding.
give something away	ruin a secret	My little sister g_ the surprise party a_ by accident.	My little sister gave the surprise party away by accident.
give something away	give something to somebody for free	The library was g_ a_ old books on Friday.	The library was giving away old books on Friday.
give something back	return a borrowed item	I have to g_ these skates b_ to Franz before his hockey game.	I have to give these skates back to Franz before his hockey game.
give in	reluctantly stop fighting or arguing	My boyfriend didn't want to go to the ballet, but he finally g_ i_.	My boyfriend didn't want to go to the ballet, but he finally gave in.
give something out	give to many people (usually at no cost)	They were g_ o_ free perfume samples at the department store.	They were giving out free perfume samples at the department store.
give something up	quit a habit	I am g_ u_ smoking as of January 1st.	I am giving up smoking as of January 1st.
give up	stop trying	My maths homework was too difficult so I g_ u_.	My maths homework was too difficult so I gave up.
go after somebody	follow somebody	My brother tried to g_ a_ the thief in his car.	My brother tried to go after the thief in his car.
go after something	try to achieve something	I w_ a_ my dream and now I am a published writer.	I went after my dream and now I am a published writer.
go against somebody	compete, oppose	We are g_ a_ the best soccer team in the city tonight.	We are going against the best soccer team in the city tonight.
go ahead	start, proceed	Please g_ a_ and eat before the food gets cold.	Please go ahead and eat before the food gets cold.
go back	return to a place	I have to g_ b_ home and get my lunch.	I have to go back home and get my lunch.
go out	leave home to go on a social event	We're g_ o_ for dinner tonight.	We're going out for dinner tonight.
go out with somebody	date	Jesse has been g_ o_ with Luke since they met last winter.	Jesse has been going out with Luke since they met last winter.
go over something	review	Please g_ o_ your answers before you submit your test.	Please go over your answers before you submit your test.
go over	visit somebody nearby	I haven't seen Tina for a long time. I think I'll g_ o_ for an hour or two.	I haven't seen Tina for a long time. I think I'll go over for an hour or two.
go without something	suffer lack or deprivation	When I was young, we w_ w_ winter boots.	When I was young, we went without winter boots.
grow apart	stop being friends over time	My best friend and I g_ a_ after she changed schools.	My best friend and I grew apart after she changed schools.
grow back	regrow	My roses g_ b_ this summer.	My roses grew back this summer.
grow into something	grow big enough to fit	This bike is too big for him now, but he should g_ i_ it by next year.	This bike is too big for him now, but he should grow into it by next year.
grow out of something	get too big for	Elizabeth needs a new pair of shoes because she has g_ o_ o_ her old ones.	Elizabeth needs a new pair of shoes because she has grown out of her old ones.
grow up	become an adult	When Jack g_ u_ he wants to be a fireman.	When Jack grows up he wants to be a fireman.
hand something down	give something used to somebody else	I h_ my old comic books d_ to my little cousin.	I handed my old comic books down to my little cousin.
hand something in	submit	I have to h_ i_ my essay by Friday.	I have to hand in my essay by Friday.
hand something out	to distribute to a group of people	We will h_ o_ the invitations at the door.	We will hand out the invitations at the door.
hand something over	give (usually unwillingly)	The police asked the man to h_ o_ his wallet and his weapons.	The police asked the man to hand over his wallet and his weapons.
hang in	stay positive (informal)	H_ i_ there. I'm sure you'll find a job very soon.	Hang in there. I'm sure you'll find a job very soon.
hang on	wait a short time (informal)	H_ o_ while I grab my coat and shoes!	Hang on while I grab my coat and shoes!
hang out	spend time relaxing (informal)	Instead of going to the party we are just going to h_ o_ at my place.	Instead of going to the party we are just going to hang out at my place.
hang up	end a phone call	He didn't say goodbye before he h_ u_.	He didn't say goodbye before he hung up.
hold somebody/ something back	prevent from doing/going	I had to h_ my dog b_ because there was a cat in the park.	I had to hold my dog back because there was a cat in the park.
hold something back	hide an emotion	Jamie h_ b_ his tears at his grandfather's funeral.	Jamie held back his tears at his grandfather's funeral.
hold on	wait a short time	Please h_ o_ while I transfer you to the Sales Department.	Please hold on while I transfer you to the Sales Department.
hold onto somebody/ something	hold firmly using your hands or arms	H_ o_ your hat because it's very windy outside.	Hold onto your hat because it's very windy outside.
hold somebody/ something up	rob	A man in a black mask h_ the bank u_ this morning.	A man in a black mask held the bank up this morning.
keep on doing something	continue doing	K_ o_ stirring until the liquid comes to a boil.	Keep on stirring until the liquid comes to a boil.
keep something from somebody	not tell	We k_ our relationship f_ our parents for two years.	We kept our relationship from our parents for two years.
keep somebody/ something out	stop from entering	Try to k_ the wet dog o_ of the living room.	Try to keep the wet dog out of the living room.
keep something up	continue at the same rate	If you k_ those results u_ you will get into a great college.	If you keep those results up you will get into a great college.
let somebody down	fail to support or help, disappoint	I need you to be on time. Don't l_ me d_ this time.	I need you to be on time. Don't let me down this time.
let somebody in	allow to enter	Can you l_ the cat i_ before you go to school?	Can you let the cat in before you go to school?
log in (or on)	sign in (to a website, database etc)	I can't l_ i_ to Facebook because I've forgotten my password.	I can't log in to Facebook because I've forgotten my password.
log out (or off)	sign out (of a website, database etc)	If you don't l_ o_ somebody could get into your account.	If you don't log off somebody could get into your account.
look after somebody/ something	take care of	I have to l_ a_ my sick grandmother.	I have to look after my sick grandmother.
look down on somebody	think less of, consider inferior	Ever since we stole that chocolate bar your dad has l_ d_ on me.	Ever since we stole that chocolate bar your dad has looked down on me.
look for somebody/ something	try to find	I'm l_ f_ a red dress for the wedding.	I'm looking for a red dress for the wedding.
look forward to something	be excited about the future	I'm lo_ f_ to the Christmas break.	I'm looking forward to the Christmas break.
look into something	investigate	We are going to l_ i_ the price of snowboards today.	We are going to look into the price of snowboards today.
look out	be careful, vigilant, and take notice	L_ o_! That car's going to hit you!	Look out! That car's going to hit you!
look out for somebody/ something	be especially vigilant for	Don't forget to l_ o_ for snakes on the hiking trail.	Don't forget to look out for snakes on the hiking trail.
look something over	check, examine	Can you l_ o_ my essay for spelling mistakes?	Can you look over my essay for spelling mistakes?
look something up	search and find information in a reference book or database	We can l_ her phone number u_ on the Internet.	We can look her phone number up on the Internet.
look up to somebody	have a lot of respect for	My little sister has always l_ u_ to me.	My little sister has always looked up to me.
make something up	invent, lie about something	Josie m_ u_ a story about why we were late.	Josie made up a story about why we were late.
make up	forgive each other	We were angry last night, but we m_ u_ at breakfast.	We were angry last night, but we made up at breakfast.
make somebody up	apply cosmetics to	My sisters m_ me u_ for my graduation party.	My sisters made me up for my graduation party.
mix something up	confuse two or more things	I m_ u_ the twins' names again!	I mixed up the twins' names again!
pass away	die	His uncle p_ a_ last night after a long illness.	His uncle passed away last night after a long illness.
pass out	faint	It was so hot in the church that an elderly lady p_ o_.	It was so hot in the church that an elderly lady passed out.
pass something out	give the same thing to many people	The professor p_ the textbooks o_ before class.	The professor passed the textbooks out before class.
pass something up	decline (usually something good)	I p_ u_ the job because I am afraid of change.	I passed up the job because I am afraid of change.
pay somebody back	return owed money	Thanks for buying my ticket. I'll p_ you b_ on Friday.	Thanks for buying my ticket. I'll pay you back on Friday.
pay for something	be punished for doing something bad	That bully will p_ f_ being mean to my little brother.	That bully will pay for being mean to my little brother.
pick something out	choose	I p_ o_ three sweaters for you to try on.	I picked out three sweaters for you to try on.
point somebody/ something out	indicate with your finger	I'll p_ my boyfriend o_ when he runs by.	I'll point my boyfriend out when he runs by.
put something down	put what you are holding on a surface or floor	You can p_ the groceries d_ on the kitchen counter.	You can put the groceries down on the kitchen counter.
put somebody down	insult, make somebody feel stupid	The students p_ the substitute teacher d_ because his pants were too short.	The students put the substitute teacher down because his pants were too short.
put something off	postpone	We are p_ o_ our trip until January because of the hurricane.	We are putting off our trip until January because of the hurricane.
put something out	extinguish	The neighbours p_ the fire o_ before the firemen arrived.	The neighbours put the fire out before the firemen arrived.
put something together	assemble	I have to p_ the crib t_ before the baby arrives.	I have to put the crib together before the baby arrives.
put up with somebody/ something	tolerate	I don't think I can p_ u_ with three small children in the car.	I don't think I can put up with three small children in the car.
put something on	put clothing/ accessories on your body	Don't forget to p_ o_ your new earrings for the party.	Don't forget to put on your new earrings for the party.
run into somebody/ something	meet unexpectedly	I r_ i_ an old school-friend at the mall.	I ran into an old school-friend at the mall.
run over somebody/ something	drive a vehicle over a person or thing	I accidentally r_ o_ your bicycle in the driveway.	I accidentally ran over your bicycle in the driveway.
run over/ through something	rehearse, review	Let's r_ o_/t_ these lines one more time before the show.	Let's run over/through these lines one more time before the show.
run away	leave unexpectedly, escape	The child r_ a_ from home and has been missing for three days.	The child ran away from home and has been missing for three days.
run out	have none left	We r_ o_ of shampoo so I had to wash my hair with soap.	We ran out of shampoo so I had to wash my hair with soap.
send something back	return (usually by mail)	My letter got s_ b_ to me because I used the wrong stamp.	My letter got sent back to me because I used the wrong stamp.
set something up	arrange, organize	Our boss s_ a meeting u_ with the president of the company.	Our boss set a meeting up with the president of the company.
set somebody up	trick, trap	The police s_ u_ the car thief by using a hidden camera.	The police set up the car thief by using a hidden camera.
shop around	compare prices	I want to s_ a_ a little before I decide on these boots.	I want to shop around a little before I decide on these boots.
show off	act extra special for people watching (usually boastfully)	He always s_ o_ on his skateboard	He always shows off on his skateboard
sleep over	stay somewhere for the night (informal)	You should s_ o_ tonight if the weather is too bad to drive home.	You should sleep over tonight if the weather is too bad to drive home.
sort something out	organize, resolve a problem	We need to s_ the bills o_ before the first of the month.	We need to sort the bills out before the first of the month.
stick to something	continue doing something, limit yourself to one particular thing	You will lose weight if you s_ t_ the diet.	You will lose weight if you stick to the diet.
switch something off	stop the energy flow, turn off	The light's too bright. Could you s_ it o_.	The light's too bright. Could you switch it off.
switch something on	start the energy flow, turn on	We heard the news as soon as we s_ o_ the car radio.	We heard the news as soon as we switched on the car radio.
take after somebody	resemble a family member	I t_ a_ my mother. We are both impatient.	I take after my mother. We are both impatient.
take something apart	purposely break into pieces	He t_ the car brakes a_ and found the problem.	He took the car brakes apart and found the problem.
take something back	return an item	I have to t_ our new TV b_ because it doesn't work.	I have to take our new TV back because it doesn't work.
take off	start to fly	My plane t_ o_ in five minutes.	My plane takes off in five minutes.
take something off	remove something (usually clothing)	T_ o_ your socks and shoes and come in the lake!	Take off your socks and shoes and come in the lake!
take something out	remove from a place or thing	Can you t_ the garbage o_ to the street for me?	Can you take the garbage out to the street for me?
take somebody out	pay for somebody to go somewhere with you	My grandparents t_ us o_ for dinner and a movie.	My grandparents took us out for dinner and a movie.
tear something up	rip into pieces	I t_ u_ my ex-boyfriend's letters and gave them back to him.	I tore up my ex-boyfriend's letters and gave them back to him.
think back	remember (often + to, sometimes + on)	When I t_ b_ on my youth, I wish I had studied harder.	When I think back on my youth, I wish I had studied harder.
think something over	consider	I'll have to t_ this job offer o_ before I make my final decision.	I'll have to think this job offer over before I make my final decision.
throw something away	dispose of	We t_ our old furniture a_ when we won the lottery.	We threw our old furniture away when we won the lottery.
turn something down	decrease the volume or strength (heat, light etc)	Please t_ the TV d_ while the guests are here.	Please turn the TV down while the guests are here.
turn something down	refuse	I t_ the job d_ because I don't want to move.	I turned the job down because I don't want to move.
turn something off	stop the energy flow, switch off	Your mother wants you to t_ the TV o_ and come for dinner.	Your mother wants you to turn the TV off and come for dinner.
turn something on	start the energy, switch on	It's too dark in here. Let's t_ some lights o_.	It's too dark in here. Let's turn some lights on.
turn something up	increase the volume or strength (heat, light etc)	Can you t_ the music u_? This is my favourite song.	Can you turn the music up? This is my favourite song.
turn up	appear suddenly	Our cat t_ u_ after we put posters up all over the neighbourhood.	Our cat turned up after we put posters up all over the neighbourhood.
try something on	sample clothing	I'm going to t_ these jeans o_, but I don't think they will fit.	I'm going to try these jeans on, but I don't think they will fit.
try something out	test	I am going to t_ this new brand of detergent o_.	I am going to try this new brand of detergent out.
use something up	finish the supply	The kids u_ all of the toothpaste u_ so we need to buy some more.	The kids used all of the toothpaste up so we need to buy some more.
wake up	stop sleeping	We have to w_ u_ early for work on Monday.	We have to wake up early for work on Monday.
warm somebody/ something up	increase the temperature	You can w_ your feet u_ in front of the fireplace.	You can warm your feet up in front of the fireplace.
warm up	prepare body for exercise	I always w_ u_ by doing sit-ups before I go for a run.	I always warm up by doing sit-ups before I go for a run.
wear off	fade away	Most of my make-up w_ o_ before I got to the party.	Most of my make-up wore off before I got to the party.
work out	exercise	I w_ o_ at the gym three times a week.	I work out at the gym three times a week.
work out	be successful	Our plan w_ o_ fine.	Our plan worked out fine.
work something out	make a calculation	We have to w_ o_ the total 	We have to work out the total 
